.6..4.89.
....693..
...5....7
85...3...
..1...2..
...4...79
1....5...
..683....
.28.1..6.
